####################################################################################################
##..##[]..[]....[]......................[]##[][][].[].....[][][]......[]....[]........[][][][][]..##
##..##..[][]........[]##[][]............##[][]....##[]....[][]......##............##..[][][][]..####
##[][]....##....[]...............[].....[].........[][].[]..[]......##....[]....##..##..##......[]##
##..[]....##[]........[].........[].......[]........................[]....[]##......##[]......##[]##
##[]....##..[]......##..##[]..[]..##...[].................##......[]##........[]..[][][]......[][]##
##..##....[]..[]........[]....[]..................................##..[]..[][]..[]....[]....##[][]##
##..[]..............[]..........[].[]..........[].....[].......[][][][].##[][]......[]....##....[]##
##[][]..........[]##......[]..........[].........[]...####....##...[]...[].[][].......[]..####..[]##
####..[][]....[]......[][]......[]##..[]...........[]..........[][][].......[]..[]..##[]..[]##..[]##
##................[]............[]............[][]...................[]........[]....[][][].....[]##
##....[]....[][]....[]..........[][]....[]......[]..##....[]##..................[]##..[][]..[]....##
##..[]............[]....##[]..[][][]......[]...[].........##[].....[].............[][][][].[].....##
##....##[]..####..[][][][]....[]..[].....[].[]..[][]..[].[].[][]##.............[]..[][].##..[]..[]##
##[]....[]................[]......####[].....[].[][]..[][]..[][][]...[].......##...............[].##
##.......[]....[].........##[]..[]..........[]....##[][][][][][][][]..[]....##[]........[]........##
##[].........[].##..##[]..####.............[][].[]..##.[][][]..........[]....................[]...##
##....[][]....##......[][]##....##........[][][]....[].......[][][]...##[]..####......[]..........##
##....[][]....[].[]...[]..[]..[]..........[][]..................[]......[]................[]......##
##.....[]....[].....[].[].........##....[][][][]##[]............[].....[][]..........[]...........##
##..[][][]....[]........##[][]..[][].......[]...[]................##....[]....[]##..............[]##
##..[]##[]....[]........[]....[]##[]..##[]....##[][]......[]......##....##......................[]##
##[]..[]......[]........[]........[]..[]........####..............[]....[]##...........[].......[]##
##............[]...[]...[]..##.......[][]....[].[]##.............[][].[].[]..................[].####
##......##..[][]..[][][].[]...........[]......##[][][]@....[].....[].....[][][]...............[]..##
##.........[].......[][]...........[][].......[]....[].[][][][].............[]......##.....[][]...##
####.....[].....##.[][][]...##............[]...[]...[][][]##.[]............[].[].........[].[]....##
##..............[]..##[].......................[]...[][]..[][]##........[]..##....[]....##.[][].[]##
##[]..[]............##...........[].....##......[]........[][][]........[][][].....[]...[]........##
####........[]..................[].[]...............##...[][]........[][]..[].......[][][]........##
####....................##......[]........................[].........[].[]..[]...[].[][].[].......##
##..[]............##[]........##[]........##....................##..[][].[].[]........[]........####
##.................[]......[]...[]..[]..................##......[]...[].[].[].........[]..........##
##......[]...[].....##....[]........[]............##..............[][][].......[]......[].....[][]##
##......[]....[]..[]...[]..[][].[]..####......##[].....................[]............[][].....[]..##
##..........[]........[]##..##..##[].......[][].##................[]....[]..........##........##..##
##[]..[]..[]..........[]##.....[]...........[].....[][][].........##....[]................[]....[]##
##..[][].........................[]...##..##[]##[][].[][].....[]##[][].[]........[].............####
##....[][][]..........##..........[]....[][][].[]...[][][]....[]...[].[]..[]..##..................##
##..[]....[]##..[]......##........[].[].##..........####..................[]...............[]...[]##
##..[]....[]..[]..[]..........[]..[]..[]##..........[][]................##[].................[]...##
##[][]..[]....[]..[]....[]..##...[][]...........####........................##..............##[]..##
##......[]..........[]##........[]..##[]......##...[][]...[]............##.....[]..............[].##
##[]..........##..##[]..[]..[][][]..##..........[][][][]..[]..................[]............##[]####
####..............[]....[]......[]....##..##....[][]......##.....[].[]........[]................[]##
##....##..........##......[]......[]..[].........[].......[]..##[]..[][]......##........[]........##
##....[]....[]..[]....[][][]......[]..[]..................[][]..[]..............[][][]##..........##
####[]..[]....[]##..[][]..[]..[][]..[]...[]...##........[]..[]..[]..[].....[].##[][][][]..........##
##........[]..[]....####..##[]....##..[]..[][]....[][]##[]..[]..##[][][]...[][][][][][][][].......##
####################################################################################################
